#########################################################################
#########################################################################
###############                          ################################
###########                          ####################################
########                          #######################################
########                          #######################################
######                                               ####################
######                                               ####################
######                                               ####################
########                          ##############     ####################
########                          ##############     ####################
##########                          ############     ####################
##############                         #########     ####################
################################################     ####################
################################################  P  ####################
################################################     ####################
#########################################################################
#########################################################################
#########################################################################
#########################################################################
