#########################################################################
#########################################################################
###############################################         #################
###############################################         #################
###################                 ###########         #################
###################                 ############  #######################
###################       P         ############  #######################
###################                 ##########                       ####
###################                 ############  #################  ####
###################                 ############  #################  ####
###################                 ############  #################  ####
###################                                   #############  ####
############################################          #############  ####
############################################          #############  ####
############################################      V   #############  ####
############################################          #############  ####
###################################################################  ####
###################################################################  ####
###################################################################  ####
###################################################################  ####
